Stage 1
#####
#OoP##
#####
=====
Stage 2
  #######
###  O  ###
#    o    #
# Oo P oO #
###  o  ###
 #   O  #
 ########
=====
Stage 3
###########
  ### P   ###
##O  o     ##
#             ##
#   oO     oO#
#############
=====
Stage 4
  #######
###     ###
# O o     #
# Oo P oO #
###  o  ###
 #   O  #
 ######
=====
Stage 5
############
#P        ##
#  oo     ##
#  #O     O#
#        #####
##########
=====
Stage 6
  #######
###  O  ###
#    o    #
# Oo P oO #
###  o  ###
 #   O  #
 ########